9 9
21 1 1 1 1 1 1 1 1
1 24 23 23 23 23 23 24 1
1 24 1 1 1 1 1 24 1
1 24 1 1 1 1 1 24 1
1 24 1 1 1 1 1 24 1
1 24 1 1 1 1 1 24 1
1 24 1 1 1 1 1 24 1
1 26 23 23 23 23 23 23 1
1 1 1 1 1 1 1 1 22
